######RRRRRRRRRRRR##################################################################################
#####RRRRRRRRRRRRRRRRR##############################################################################
#####RRRRRRRRRRRRRRRRRRR############################################################################
#####RRRRRRRRRRRRRRRRRRRRRR#########################################################################
####RRRRRRRRRRRRRRRRRRRRRRRRR#######################################################################
##RRRRRRRRRRRRBRRRRRRRRRRRRRRRR#####################################################################
#RRRRRRRRRRRRRBBBBBRRRRRRRRRRRRRR###################################################################
RRRRRRRRRRRRRRBBBBBBBBRRRRRRRRRRRR##################################################################
RRRRRRRRRRRRRBBBBBBBBBBBRRRRRRRRRRRR################################################################
RRRRRRRBBBBBBBBBBBBBBBBBBBRRRRRRRRRRR###############################################################
RRRRRBBBBBBBBBBBBBBBBBBBBBBBRRRRRRRRRR##############################################################
RRRRRBBBBBBBBBBBBBBBBBBBBBBBBBRRRRRRRRR#############################################################
RRRRBBBBBBBBBBBBBBBBBBBBBBBBBBBRRRRRRRRR############################################################
RRRRBBBBBBBBBBBBBBBBBBBBBBBBBBBBBRRRRRRRR#########################RRRRRRR###########################
RRRRBBBBBBBBBBBBBBBBBBBBBBBBBBBBBBRRRRRRRR######################RRRRRRRRRR##########################
RRRRBBBBBBBBBBBBBBBBBBBBBBBBBBBBBBBRRRRRRR####################RRRRRRRRRRRR##########################
RRRRBBBBBBBBBBBBBBBBBBBBBBBBBBBBBBBBRRRRRRR##################RRRRRRRRRRRRRR#########################
RRRBBBBBBBBBBBBBBBBBBBBBBBBBBBBBBBBBBRRRRRR################RRRRRRRRRRRRRRRR#########################
RRRBBBBBBBBBBBBBBBBBBBBBBBBBBBBBBBBBBRRRRRR###############RRRRRRRRRRRRRRRRR#########################
RRRBBBBBBBBBBBBBBBBBBBBBBBBBBBBBBBBBBBRRRRR##############RRRRRRRRR####RRRRR#########################
RRRBBBBBBBBBBBBBBBBBBBBBBBBBBBBBBBBBBBRRRRR#############RRRRRRRRR#####RRRRR#########################
RRRRBBBBBBBBBBBBBBBBBBBBBBBBBBBBBBBBBBRRRRR############RRRRRRRR#######RRRRR#########################
RRRRBBBBBBBBBBBBBBBBBBBBBBBBBBBBBBBBBBRRRRR###########RRRRRRRR########RRRRR#########################
RRRRBBBBBBBBBBBBBBBBBBBBBBBBBBBBBBBBBBRRRRR##########RRRRRRRR#########RRRRR#########################
RRRRBBBBBBBBBBBBBBBBBBBBBBBBBBBBBBBBBBRRRRR#########RRRRRRRR##########RRRRR#########################
RRRRRBBBBBBBBBBBBBBBBBBBBBBBBBBBBBBBBBRRRRRRR######RRRRRRRR###########RRRRR#########################
RRRRRBBBBBBBBBBBBBBBBBBBBBBBBBBBBBBBBRRRRRRRRR#####RRRRRRR############RRRRR#########################
RRRRRRBBBBBBBBBBBBBBBBBBBBBBBBBBBBBBBRRRRRRRRR####RRRRRRR############RRRRRR#########################
RRRRRRBBBBBBBBBBBBBBBBBBBBBBBBBBBBBBBRRRRRRRRRR##RRRRRRR#############RRRRRR#########################
RRRRRRBBBBBBBBBBBBBBBBBBBBBBBBBBBBBBBBRRRRRRRRR#RRRRRRRR############RRRRRRR#########################
#RRRRRRBBBBBBBBBBBBBBBBBBBBBBBBBBBBBBBBRRRRRRRR#RRRRRRR############RRRRRRR##########################
#RRRRRRBBBBBBBBBBBBBBBBBBBBBBBBBBBBBBBBBRBRRRRRRRRRRRR############RRRRRRRR##########################
##RRRRRRBBBBBBBBBBBBBBBBBBBBBBBBBBBBBBBBBBRRRRRRRRRRR###########RRRRRRRRR###########################
##RRRRRRRBBBBBBBBBBBBBBBBBBBBBBBBBBBBBBBBBRRRRRRRRRRR##########RRRRRRRRR############################
##RRRRRRRBBBBBBBBBBBBBBBBBBBBBBBBBBBBBBBBBRRRRRRRRRR#########RRRRRRRRRR#############################
###RRRRRRRRBBBBBBBBBBBBBBBBBBBBBBBBBBBBBBBBRRRRRRRR#########RRRRRRRRRR##############################
####RRRRRRRRBBBBBBBBBBBBBBBBBBBBBBBBBBBBBBBRRRRRRRR#######RRRRRRRRRR################################
#####RRRRRRRRRRBBBBBBBBBBBBBBBBBBBBBBBBBBBBRRRRRRR#######RRRRRRRRRR#################################
######RRRRRRRRRRBBBBBBBBBBBBBBBBBBBBBBBBBBBRRRRRR######RRRRRRRRRRR##################################
#######RRRRRRRRRBBBBBBBBBBBBBBBBBBBBBBBBBBBBRRRRR#####RRRRRRRRRR####################################
########RRRRRRRRBBBBBBBBBBBBBBBBBBBBBBBBBBBBRRRRRR###RRRRRRRRR######################################
#########RRRRRRRBBBBBBBBBBBBBBBBBBBBBBBBBBBBRRRRRR##RRRRRRRRR#######################################
###########RRRRRBBBBBBBBBBBBBBBBBBBBBBBBBBBBRRRRRR#RRRRRRRR#########################################
###########RRRRRBBBBBBBBBBBBBBBBBBBBBBBBBBBBBRRRRR#RRRRRRR##########################################
###########RRRRRBBBBBBBBBBBBBBBBBBBBBBBBBBBBBRRRRRRRRRRRR###########################################
###########RRRRRBBBBBBBBBBBBRRRRRRRRRRRRRRRBBRRRRRRRRRRR############################################
###########RRRRRBBBBBBBBBRRRRRRRRRRRRRRRRRRRBBRRRRRRRRR#############################################
###########RRRRRBBBBBBBRRRRRRRRRRRRRRRRRRRRRBBRRRRRR################################################
###########RRRRRBBBBBRRRRRRRRRRRRRRRRRRRRRRRBBRRRRRR################################################
###########RRRRRBBBRRRRRRRRRRRRRRRRRRRRRRRRRBBBRRRRRR###############################################
###########RRRRRBBRRRRRRRRRRRRR########RRRRRBBBRRRRRR###############################################
###########RRRRRRRRRRRRRRRR###########RRRRRRBBBRRRRRR###############################################
###########RRRRRRRRRRRRRR#############RRRRRRBBBBRRRRRR##############################################
###########RRRRRRRRRRRRR############RRRRRRRRBBBBRRRRRR##############################################
###########RRRRRRRRRRR############RRRRRRRRRBBBBBBRRRRRR#############################################
###########RRRRRRRRRR##########RRRRRRRRRRRBBBBBBBRRRRRR#############################################
###########RRRRRRRR#######RRRRRRRRRRRRRRRBBBBBBBBRRRRRRR############################################
############RRRRRRRRRRRRRRRRRRRRRRRRRRRRBBBBBBBBBBRRRRRR############################################
############RRRRRRRRRRRRRRRRRRRRRRRRRRRBBBBBBBBBBBRRRRRR############################################
############RRRRRRRRRRRRRRRRRRRRRRRRRBBBBBBBBBBBBBBRRRRRR###########################################
############RRRRRRRRRRRRRRRRRRRRRRBBBBBBBBBBBBBBBBBRRRRRR###########################################
############RRRRRRRRRRRRRRRRRBBBBBBBBBBBBBBBBBBBBBBBRRRRR######RRRRRRRR#############################
############RRRRRRRBBBBBBBBBBBBBBBBBBBBBBBBBBBBBBBBBRRRRRRRRRRRRRRRRRRRRR###########################
#############RRRRRBBBBBBBBBBBBBBBBBBBBBBBBBBBBBBBBBBRRRRRRRRRRRRRRRRRRRRRRR#########################
#############RRRRRBBBBBBBBBBBBBBBBBBBBBBBBBBBBBBBBBBBRRRRRRRRRRRRRRRRRRRRRRRR#######################
#############RRRRRBBBBBBBBBBBBBBBBBBBBBBBBBBBBBBBBBBBRRRRRRRRRRRRRRRRRRRRRRRRR######################
#############RRRRRBBBBBBBBBBBBBBBBBBBBBBBBBBBBBBBBBBBBRRRRRRRRRRRRBBRRRRRRRRRRRR####################
#############RRRRRBBBBBBBBBBBBBBBBBBBBBBBBBBBBBBBBBBBBBBBBBBBBBBBBBBBBRRRRRRRRRRR###################
#############RRRRRBBBBBBBBBBBBBBBBBBBBBBBBBBBBBBBBBBBBBBBBBBBBBBBBBBBBBBRRRRRRRRRR##################
#############RRRRRBBBBBBBBBBBBBBBBBBBBBBBBBBBBBBBBBBBBBBBBBBBBBBBBBBBBBBBBRRRRRRRR##################
#############RRRRRBBBBBBBBBBBBBBBBBBBBBBBBBBBBBBBBBBBBBBBBBBBBBBBBBBBBBBBBBBRRRRRR##################
#############RRRRRBBBBBBBBBBBBBBBBBBBBBBBBBBBBBBBBBBBBBBBBBBBBBBBBBBBBBBBBBBRRRRRR##################
#############RRRRRBBBBBBBBBBBBBBBBBBBBBBBBBBBBBBBBBBBBBBBBBBBBBBBBBBBBBBBBBBRRRRRR##################
#############RRRRRBBBBBBBBBBBBBBBBBBBBBBBBBBBBBBBBBBBBBBBBBBBBBBBBBBBBBBBBBBRRRRR###################
#############RRRRRBBBBBBBBBBBBBBBBBBBBBBBBBBBBBBBBBBBBBBBBBBBBBBBBBBBBBBBBBRRRRRR###################
#############RRRRRBBBBBBBBBBBBBBBBBBBBBBBBBBBBBBBBBBBBBBBBBBBBBBBBBBBBBBBBBRRRRRR###################
#############RRRRRBBBBBBBBBBBBBBBBBBBBBBBBBBBBBBBBBBBBBBBBBBBBBBBBBBBBBBBBRRRRRR####################
#############RRRRRBBBBBBBBBBBBBBBBBBBBBBBBBBBBBBBBBBBBBBBBBBBBBBBBBBBBBBRRRRRRRR####################
#############RRRRRBBBBBBBBBBBBBBBBBBBBBBBBBBBBBBBBBBBBBBBBBBBBBBBBBBBRRRRRRRRRR#####################
#############RRRRRBBBBBBBBBBBBBBBBBBBBBBBBBBBBBBBRRRRRRRRRRRRRRRRRRRRRRRRRRRRRR#####################
############RRRRRRBBBBBBBBBBBBBBBBBBBBBBBBBBBBBBRRRRRRRRRRRRRRRRRRRRRRRRRRRRRR######################
############RRRRRRBBBBBBBBBBBBBBBBBBBBBBBBBBBBBBRRRRRRRRRRRRRRRRRRRRRRRRRRRRR#######################
############RRRRRRBBBBBBBBBBBBBBBBBBBBBBBBBBBBBBRRRRRRRRRRRRRRRRRRRRRRRRRRR#########################
############RRRRRBBBBBBBBBBBBBBBBBBBBBBBBBBBBBBBBRRRRRRRRRRRRRRRRRRRRRRR############################
############RRRRRBBBBBBBBBBBBBBBBBBBBBBBBBBBBBBBBBBBBBBBRRRRRRRRRRRRR###############################
############RRRRRRBBBBBBBBBBBBBBBBBBBBBBBBBBBBBBBBBBBBBBBBBRRRRRRRRRRR##############################
############RRRRRRBBBBBBBBBBBBBBBBBBBBBBBBBBBBBBBBBBBBBBBBBBBBRRRRRRRRR#############################
############RRRRRRBBBBBBBBBBBBBBBBBBBBBBBBBBBBBBBBBBBBBBBBBBBBBRRRRRRRR#############################
#############RRRRRBBBBBBBBBBBBBBBBBBBBBBBBBBBBBBBBBBBBBBBBBBBBBBBRRRRRR#############################
#############RRRRRRBBBBBBBBBBBBBBBBBBBBBBBBBBBBBBBBBBBBBBBBBBBBBBBRRRRR#############################
#############RRRRRRBBBBBBBBBBBBBBBBBBBBBBBBBBBBBBBBBBBBBBBBBBBBBBBRRRRR#############################
#############RRRRRRRRBBBBBBBBBBBBBBBBBBBBBBBBBBBBBBBBBBBBBBBBBBBBBRRRRR#############################
##############RRRRRRRRBBBBBBBBBBBBBBBBBBBBBBBBBBBBBBBBBBBBBBBBBBBRRRRRR#############################
###############RRRRRRRRRRBBBBBBBBBBBBBBBBBBBBBBBBBBBBBBBBBBBBBBBRRRRRRR#############################
################RRRRRRRRRRRBBBBBBBBBBBBBBBBBBBBBBBBBBBBBBBBBBBRRRRRRRRR#############################
#################RRRRRRRRRRRRBBBBBBBBBBBBBBBBBBBBBBBBBBBBBBBBRRRRRRRRR##############################
##################RRRRRRRRRRRRRRBBBBBBBBBBBBBBBBBBBBBBBBBBBRRRRRRRRRR###############################
####################RRRRRRRRRRRRRRRRRRRRRRRBBBBBBBBBBBBBBRRRRRRRRRRR################################
######################RRRRRRRRRRRRRRRRRRRRRRRRRRRRRRRRRRRRRRRRRRRRR#################################
#########################RRRRRRRRRRRRRRRRRRRRRRRRRRRRRRRRRRRRRRRR###################################
